File: dir,	Node: Top,	This is the top of the INFO tree.

This is the Info main menu (aka directory node).
A few useful Info commands:

  'q' quits;
  '?' lists all Info commands;
  'h' starts the Info tutorial;
  'mTexinfo RET' visits the Texinfo manual, etc.

* Menu:

Basics
* Common options: (coreutils)Common options.
* Coreutils: (coreutils).       Core GNU (file, text, shell) utilities.
* Date input formats: (coreutils)Date input formats.
* Ed: (ed).                     The GNU line editor
* File permissions: (coreutils)File permissions.
                                Access modes.
* Finding files: (find).        Operating on files matching certain criteria.

C++ libraries
* autosprintf: (autosprintf).   Support for printf format strings in C++.

Compression
* Gzip: (gzip).                 General (de)compression of files (lzw).

Development
* OpenOCD: (openocd).           OpenOCD User's Guide
* SSIP: (ssip).                 Speech Synthesis Interface Protocol.
* Speech Dispatcher: (speech-dispatcher).
                                Speech Dispatcher.
* libffi: (libffi).             Portable foreign-function interface library.

DOS
* Mtools: (mtools).             Mtools: utilities to access DOS disks in Unix.

Editors
* nano: (nano).                 Small and friendly text editor.

Emacs
* Emacs: (emacs-24/emacs).      The extensible self-documenting text editor.
* Emacs FAQ: (emacs-24/efaq).   Frequently Asked Questions about Emacs.

Emacs editing modes
* Ada mode: (emacs-24/ada-mode).
                                Emacs mode for editing and compiling Ada code.
* CC Mode: (emacs-24/ccmode).   Emacs mode for editing C, C++, Objective-C, 
                                  Java, Pike, AWK, and CORBA IDL code.
* IDLWAVE: (emacs-24/idlwave).  Major mode and shell for IDL files.
* Octave mode: (emacs-24/octave-mode).
                                Emacs mode for editing GNU Octave files.
* Org Mode: (emacs-24/org).     Outline-based notes management and organizer
* nXML Mode: (emacs-24/nxml-mode).
                                XML editing mode with RELAX NG support.

Emacs lisp
* Elisp: (emacs-24/elisp).      The Emacs Lisp Reference Manual.
* Emacs Lisp Intro: (emacs-24/eintr).
                                A simple introduction to Emacs Lisp 
                                  programming.

Emacs lisp libraries
* Auth-source: (emacs-24/auth). The Emacs auth-source library.
* CL: (emacs-24/cl).            Partial Common Lisp support for Emacs Lisp.
* D-Bus: (emacs-24/dbus).       Using D-Bus in Emacs.
* Emacs MIME: (emacs-24/emacs-mime).
                                Emacs MIME de/composition library.
* SMTP: (emacs-24/smtpmail).    Emacs library for sending mail via SMTP.
* URL: (emacs-24/url).          URL loading package.
* Widget: (emacs-24/widget).    The "widget" package used by the Emacs 
                                  Customization facility.

Emacs misc features
* Autotype: (emacs-24/autotype).
                                Convenient features for text that you enter 
                                  frequently in Emacs.
* Bovine: (emacs-24/bovine).    Semantic bovine parser development.
* Calc: (emacs-24/calc).        Advanced desk calculator and mathematical tool.
* Dired-X: (emacs-24/dired-x).  Dired Extra Features.
* EDE: (emacs-24/ede).          The Emacs Development Environment.
* EDT: (emacs-24/edt).          An Emacs emulation of the EDT editor.
* EIEIO: (emacs-24/eieio).      An objects system for Emacs Lisp.
* ERT: (emacs-24/ert).          Emacs Lisp regression testing tool.
* EWW: (emacs-24/eww).          Emacs Web Wowser
* EasyPG Assistant: (emacs-24/epa).
                                An Emacs user interface to GNU Privacy Guard.
* Ebrowse: (emacs-24/ebrowse).  A C++ class browser for Emacs.
* Ediff: (emacs-24/ediff).      A visual interface for comparing and merging 
                                  programs.
* Eshell: (emacs-24/eshell).    A command shell implemented in Emacs Lisp.
* Flymake: (emacs-24/flymake).  A universal on-the-fly syntax checker.
* Forms: (emacs-24/forms).      Emacs package for editing data bases by 
                                  filling in forms.
* Htmlfontify: (emacs-24/htmlfontify).
                                Convert source code to html.
* Ido: (emacs-24/ido).          Interactively do things with buffers and files.
* PCL-CVS: (emacs-24/pcl-cvs).  Emacs front-end to CVS.
* RefTeX: (emacs-24/reftex).    Emacs support for LaTeX cross-references and 
                                  citations.
* Remember: (emacs-24/remember).
                                Simple information manager for Emacs.
* SES: (emacs-24/ses).          Simple Emacs Spreadsheet.
* SRecode: (emacs-24/srecode).  Semantic template code generator.
* Semantic: (emacs-24/semantic).
                                Source code parser library and utilities.
* Speedbar: (emacs-24/speedbar).
                                File/Tag summarizing utility.
* Todo Mode: (emacs-24/todo-mode).
                                Make and maintain todo lists.
* VIP: (emacs-24/vip).          An older VI-emulation for Emacs.
* VIPER: (emacs-24/viper).      A VI-emulation mode for Emacs.
* Wisent: (emacs-24/wisent).    Semantic Wisent parser development.
* WoMan: (emacs-24/woman).      Browse UN*X Manual Pages "W.O. (without) Man".

Emacs network features
* ERC: (emacs-24/erc).          Powerful and extensible IRC client for Emacs.
* EUDC: (emacs-24/eudc).        Emacs client for directory servers (LDAP, PH).
* Emacs GnuTLS: (emacs-24/emacs-gnutls).
                                The Emacs GnuTLS integration.
* Gnus: (emacs-24/gnus).        The newsreader Gnus.
* MH-E: (emacs-24/mh-e).        Emacs interface to the MH mail system.
* Mairix: (emacs-24/mairix-el). Emacs interface to the Mairix mail indexer.
* Message: (emacs-24/message).  Mail and news composition mode that goes with 
                                  Gnus.
* Newsticker: (emacs-24/newsticker).
                                A Newsticker for Emacs.
* PGG: (emacs-24/pgg).          Emacs interface to various PGP implementations.
* Rcirc: (emacs-24/rcirc).      Internet Relay Chat (IRC) client.
* SASL: (emacs-24/sasl).        The Emacs SASL library.
* SC: (emacs-24/sc).            Supercite lets you cite parts of messages 
                                  youâ€™re replying to, in flexible ways.
* Sieve: (emacs-24/sieve).      Managing Sieve scripts in Emacs.
* TRAMP: (emacs-24/tramp).      Transparent Remote Access, Multiple Protocol 
                                  Emacs remote file access via ssh and scp.

GNU Gettext Utilities
* autopoint: (gettext)autopoint Invocation.
                                Copy gettext infrastructure.
* envsubst: (gettext)envsubst Invocation.
                                Expand environment variables.
* gettextize: (gettext)gettextize Invocation.
                                Prepare a package for gettext.
* gettext: (gettext).           GNU gettext utilities.
* ISO3166: (gettext)Country Codes.
                                ISO 3166 country codes.
* ISO639: (gettext)Language Codes.
                                ISO 639 language codes.
* msgattrib: (gettext)msgattrib Invocation.
                                Select part of a PO file.
* msgcat: (gettext)msgcat Invocation.
                                Combine several PO files.
* msgcmp: (gettext)msgcmp Invocation.
                                Compare a PO file and template.
* msgcomm: (gettext)msgcomm Invocation.
                                Match two PO files.
* msgconv: (gettext)msgconv Invocation.
                                Convert PO file to encoding.
* msgen: (gettext)msgen Invocation.
                                Create an English PO file.
* msgexec: (gettext)msgexec Invocation.
                                Process a PO file.
* msgfilter: (gettext)msgfilter Invocation.
                                Pipe a PO file through a filter.
* msgfmt: (gettext)msgfmt Invocation.
                                Make MO files out of PO files.
* msggrep: (gettext)msggrep Invocation.
                                Select part of a PO file.
* msginit: (gettext)msginit Invocation.
                                Create a fresh PO file.
* msgmerge: (gettext)msgmerge Invocation.
                                Update a PO file from template.
* msgunfmt: (gettext)msgunfmt Invocation.
                                Uncompile MO file into PO file.
* msguniq: (gettext)msguniq Invocation.
                                Unify duplicates for PO file.
* ngettext: (gettext)ngettext Invocation.
                                Translate a message with plural.
* xgettext: (gettext)xgettext Invocation.
                                Extract strings into a PO file.

GNU organization
* Maintaining Findutils: (find-maint).
                                Maintaining GNU findutils

GNU Packages
* CVS: (cvs).                   Concurrent Versions System

GNU Utilities
* dirmngr: (gnupg).             X.509 CRL and OCSP server.
* dirmngr-client: (gnupg).      X.509 CRL and OCSP client.
* gpg-agent: (gnupg).           The secret key daemon.
* gpg2: (gnupg).                OpenPGP encryption and signing tool.
* gpgsm: (gnupg).               S/MIME encryption and signing tool.
* gpg: (gnupg1).                OpenPGP encryption and signing tool (v1).

Individual utilities
* aclocal-invocation: (automake-1.15)aclocal Invocation.
                                                Generating aclocal.m4.
* arch: (coreutils)arch invocation.             Print machine hardware name.
* automake-invocation: (automake-1.15)automake Invocation.
                                                Generating Makefile.in.
* base32: (coreutils)base32 invocation.         Base32 encode/decode data.
* base64: (coreutils)base64 invocation.         Base64 encode/decode data.
* basename: (coreutils)basename invocation.     Strip directory and suffix.
* cat: (coreutils)cat invocation.               Concatenate and write files.
* chcon: (coreutils)chcon invocation.           Change SELinux CTX of files.
* chgrp: (coreutils)chgrp invocation.           Change file groups.
* chmod: (coreutils)chmod invocation.           Change access permissions.
* chown: (coreutils)chown invocation.           Change file owners and groups.
* chroot: (coreutils)chroot invocation.         Specify the root directory.
* cksum: (coreutils)cksum invocation.           Print POSIX CRC checksum.
* cmp: (diffutils)Invoking cmp.                 Compare 2 files byte by byte.
* comm: (coreutils)comm invocation.             Compare sorted files by line.
* cp: (coreutils)cp invocation.                 Copy files.
* csplit: (coreutils)csplit invocation.         Split by context.
* cut: (coreutils)cut invocation.               Print selected parts of lines.
* cvs: (cvs)CVS commands.                       Concurrent Versions System
* date: (coreutils)date invocation.             Print/set system date and time.
* dd: (coreutils)dd invocation.                 Copy and convert a file.
* df: (coreutils)df invocation.                 Report file system disk usage.
* diff: (diffutils)Invoking diff.               Compare 2 files line by line.
* diff3: (diffutils)Invoking diff3.             Compare 3 files line by line.
* dir: (coreutils)dir invocation.               List directories briefly.
* dircolors: (coreutils)dircolors invocation.   Color setup for ls.
* dirname: (coreutils)dirname invocation.       Strip last file name component.
* du: (coreutils)du invocation.                 Report on disk usage.
* echo: (coreutils)echo invocation.             Print a line of text.
* env: (coreutils)env invocation.               Modify the environment.
* expand: (coreutils)expand invocation.         Convert tabs to spaces.
* expr: (coreutils)expr invocation.             Evaluate expressions.
* factor: (coreutils)factor invocation.         Print prime factors
* false: (coreutils)false invocation.           Do nothing, unsuccessfully.
* find: (find)Invoking find.                    Finding and acting on files.
* fmt: (coreutils)fmt invocation.               Reformat paragraph text.
* fold: (coreutils)fold invocation.             Wrap long input lines.
* groups: (coreutils)groups invocation.         Print group names a user is in.
* gunzip: (gzip)Overview.                       Decompression.
* gzexe: (gzip)Overview.                        Compress executables.
* head: (coreutils)head invocation.             Output the first part of files.
* hostid: (coreutils)hostid invocation.         Print numeric host identifier.
* hostname: (coreutils)hostname invocation.     Print or set system name.
* id: (coreutils)id invocation.                 Print user identity.
* install: (coreutils)install invocation.       Copy files and set attributes.
* join: (coreutils)join invocation.             Join lines on a common field.
* kill: (coreutils)kill invocation.             Send a signal to processes.
* link: (coreutils)link invocation.             Make hard links between files.
* ln: (coreutils)ln invocation.                 Make links between files.
* locate: (find)Invoking locate.                Finding files in a database.
* logname: (coreutils)logname invocation.       Print current login name.
* ls: (coreutils)ls invocation.                 List directory contents.
* md5sum: (coreutils)md5sum invocation.         Print or check MD5 digests.
* mkdir: (coreutils)mkdir invocation.           Create directories.
* mkfifo: (coreutils)mkfifo invocation.         Create FIFOs (named pipes).
* mknod: (coreutils)mknod invocation.           Create special files.
* mktemp: (coreutils)mktemp invocation.         Create temporary files.
* mv: (coreutils)mv invocation.                 Rename files.
* nice: (coreutils)nice invocation.             Modify niceness.
* nl: (coreutils)nl invocation.                 Number lines and write files.
* nohup: (coreutils)nohup invocation.           Immunize to hangups.
* nproc: (coreutils)nproc invocation.           Print the number of processors.
* numfmt: (coreutils)numfmt invocation.         Reformat numbers.
* od: (coreutils)od invocation.                 Dump files in octal, etc.
* paste: (coreutils)paste invocation.           Merge lines of files.
* patch: (diffutils)Invoking patch.             Apply a patch to a file.
* pathchk: (coreutils)pathchk invocation.       Check file name portability.
* pr: (coreutils)pr invocation.                 Paginate or columnate files.
* printenv: (coreutils)printenv invocation.     Print environment variables.
* printf: (coreutils)printf invocation.         Format and print data.
* ptx: (coreutils)ptx invocation.               Produce permuted indexes.
* pwd: (coreutils)pwd invocation.               Print working directory.
* readlink: (coreutils)readlink invocation.     Print referent of a symlink.
* realpath: (coreutils)realpath invocation.     Print resolved file names.
* rm: (coreutils)rm invocation.                 Remove files.
* rmdir: (coreutils)rmdir invocation.           Remove empty directories.
* runcon: (coreutils)runcon invocation.         Run in specified SELinux CTX.
* sdiff: (diffutils)Invoking sdiff.             Merge 2 files side-by-side.
* seq: (coreutils)seq invocation.               Print numeric sequences
* sha1sum: (coreutils)sha1sum invocation.       Print or check SHA-1 digests.
* sha2: (coreutils)sha2 utilities.              Print or check SHA-2 digests.
* shred: (coreutils)shred invocation.           Remove files more securely.
* shuf: (coreutils)shuf invocation.             Shuffling text files.
* sleep: (coreutils)sleep invocation.           Delay for a specified time.
* sort: (coreutils)sort invocation.             Sort text files.
* split: (coreutils)split invocation.           Split into pieces.
* stat: (coreutils)stat invocation.             Report file(system) status.
* stdbuf: (coreutils)stdbuf invocation.         Modify stdio buffering.
* stty: (coreutils)stty invocation.             Print/change terminal settings.
* sum: (coreutils)sum invocation.               Print traditional checksum.
* sync: (coreutils)sync invocation.             Synchronize memory to disk.
* tac: (coreutils)tac invocation.               Reverse files.
* tail: (coreutils)tail invocation.             Output the last part of files.
* tee: (coreutils)tee invocation.               Redirect to multiple files.
* test: (coreutils)test invocation.             File/string tests.
* time: (time).                                 Run programs and summarize 
                                                  system resource usage.
* timeout: (coreutils)timeout invocation.       Run with time limit.
* touch: (coreutils)touch invocation.           Change file timestamps.
* tr: (coreutils)tr invocation.                 Translate characters.
* true: (coreutils)true invocation.             Do nothing, successfully.
* truncate: (coreutils)truncate invocation.     Shrink/extend size of a file.
* tsort: (coreutils)tsort invocation.           Topological sort.
* tty: (coreutils)tty invocation.               Print terminal name.
* uname: (coreutils)uname invocation.           Print system information.
* unexpand: (coreutils)unexpand invocation.     Convert spaces to tabs.
* uniq: (coreutils)uniq invocation.             Uniquify files.
* unlink: (coreutils)unlink invocation.         Removal via unlink(2).
* updatedb: (find)Invoking updatedb.            Building the locate database.
* uptime: (coreutils)uptime invocation.         Print uptime and load.
* users: (coreutils)users invocation.           Print current user names.
* vdir: (coreutils)vdir invocation.             List directories verbosely.
* wc: (coreutils)wc invocation.                 Line, word, and byte counts.
* who: (coreutils)who invocation.               Print who is logged in.
* whoami: (coreutils)whoami invocation.         Print effective user ID.
* xargs: (find)Invoking xargs.                  Operating on many files.
* yes: (coreutils)yes invocation.               Print a string indefinitely.
* zcat: (gzip)Overview.                         Decompression to stdout.
* zdiff: (gzip)Overview.                        Compare compressed files.
* zforce: (gzip)Overview.                       Force .gz extension on files.
* zgrep: (gzip)Overview.                        Search compressed files.
* zmore: (gzip)Overview.                        Decompression output by pages.

Kernel
* GRUB: (grub).                 The GRand Unified Bootloader
* grub-dev: (grub-dev).         The GRand Unified Bootloader Dev
* grub-install: (grub)Invoking grub-install.
                                Install GRUB on your drive
* grub-mkconfig: (grub)Invoking grub-mkconfig.
                                Generate GRUB configuration
* grub-mkpasswd-pbkdf2: (grub)Invoking grub-mkpasswd-pbkdf2.
* grub-mkrelpath: (grub)Invoking grub-mkrelpath.
* grub-mkrescue: (grub)Invoking grub-mkrescue.
                                Make a GRUB rescue image
* grub-mount: (grub)Invoking grub-mount.
                                Mount a file system using GRUB
* grub-probe: (grub)Invoking grub-probe.
                                Probe device information
* grub-script-check: (grub)Invoking grub-script-check.

Libraries
* RLuserman: (rluserman).       The GNU readline library User's Manual.

Math
* bc: (bc).                     An arbitrary precision calculator language.
* dc: (dc).                     Arbitrary precision RPN "Desktop Calculator".

Network applications
* Wget: (wget).                 Non-interactive network downloader.

Programming
* cvsclient: (cvsclient).       The CVS client/server protocol.
* flex: (flex).                 Fast lexical analyzer generator (lex 
                                  replacement).

Software development
* Automake: (automake-1.15).    Making GNU standards-compliant Makefiles.

Sound
* SSIP: (ssip).                 Speech Synthesis Interface Protocol.
* Say for Speech Dispatcher: (spd-say).
                                Say.
* Speech Dispatcher: (speech-dispatcher).
                                Speech Dispatcher.

Texinfo documentation system
* Info: (emacs-24/info).        How to use the documentation browsing system.

Text creation and manipulation
* Diffutils: (diffutils).       Comparing and merging files.
* M4: (m4).                     A powerful macro processor.
* grep: (grep).                 Print lines matching a pattern.
* sed: (sed).                   Stream EDitor.  
